#domain
hospital
#levelname
MAExample
#colors
red: 0, A
green: 1, B
blue: 2, C
cyan: Z
#initial
++++++++++++++++
+ 0++++++ ++++++
+ +++++++A++++++
+ +++++++ ++++ +
+              +
+B++++++++++++A+
+ +1           +
+ ++++++++++++++
++++++++++++++++
#goal
++++++++++++++++
+  ++++++A++++++
+ +++++++ ++++++
+ +++++++ ++++A+
+              +
+ ++++++++++++ +
+B+            +
+ ++++++++++++++
++++++++++++++++
#end
