#domain
hospital
#levelname
MAAIFather
#colors
blue: 0, A
red: 1, C
#initial
++++++++++++
+++++A++++++
+++++ ++++++
+++++ ++++++
+++++C++++++
++    1 0+++
++++++++++++
#goal
++++++++++++
+++++ ++++++
+++++ ++++++
+++++ ++++++
+++++ ++++++
++AC     +++
++++++++++++
#end
