#domain
hospital
#levelname
MAExample
#colors
red: 0, A
green: 1, B
blue: 2, C
#initial
+++++++++++
+    +2  ++
+       1++
+    +0 + +
+ +++++++A+
+         +
+B+++++++ +
+ +C      +
+ +   +++++
+++++++++++
#goal
+++++++++++
+    +   ++
+        ++
+    +  +A+
+ +++++++ +
+         +
+ +++++++ +
+B+       +
+ +C  +++++
+++++++++++
#end