#domain
hospital
#levelname
MAExample
#colors
red: 0, A
green: 1, B
blue: 2, C
#initial
+++++++++++
+       + +
+     A0+ +
+ +++++++ +
+         +
+B+++++++ +
+ +       +
+ +12C+++++
+++++++++++
#goal
+++++++++++
+       + +
+  A    + +
+ +++++++ +
+         +
+ +++++++ +
+B+       +
+ + C +++++
+++++++++++
#end
