#domain
hospital
#levelname
MAExample
#colors
red: 0, B
#initial
++++++++++++
+         ++
+       0+ +
+ ++++++++B+
+          +
+ ++++++++ +
+ +        +
++++++++++++
#goal
++++++++++++
+         ++
+        +B+
+ ++++++++ +
+          +
+ ++++++++ +
+ +        +
++++++++++++
#end
