#domain
hospital
#levelname
MAExample
#colors
red: 0, B
blue: 1, A
#initial
++++++++++++
+       0+ +
+A++++++++B+
+ 1        +
+ ++++++++++
+ ++++++++++
++++++++++++
#goal
++++++++++++
+        +B+
+ ++++++++ +
+          +
+ ++++++++++
+A++++++++++
++++++++++++
#end
