#domain
hospital
#levelname
MAExample
#colors
red: 0, A
green: 1, B
blue: 2, C
#initial
+++++++++++
+       + +
+    01 + +
+ +++++++A+
+         +
+B+++++++ +
+ +       +
+ +   +++++
+++++++++++
#goal
+++++++++++
+       + +
+       +A+
+ +++++++ +
+         +
+ +++++++ +
+B+       +
+ +   +++++
+++++++++++
#end