#domain
hospital
#levelname
MAExample
#colors
red: 0, A
green: 1, B
blue: 2, C
#initial
+++++++++++
+       0++
+    +1 + +
+ +++++++A+
+         +
+B+++++++ +
+ +       +
+ +   +++++
+++++++++++
#goal
+++++++++++
+        ++
+    +  +A+
+ +++++++ +
+         +
+ +++++++ +
+ +       +
+B+   +++++
+++++++++++
#end