#domain
hospital
#levelname
MAExample
#colors
red: 0, A
green: 1, B
blue: 2, C
#initial
++++++++++
+      + +
+   A 0+ +
+ ++++++ +
+        +
+ ++++++ +
+ +1     +
+ +B +++++
++++++++++
#goal
++++++++++
+      + +
+      +A+
+ ++++++ +
+        +
+ ++++++ +
+B+      +
+ +  +++++
++++++++++
#end
