#domain
hospital
#levelname
MAExample
#colors
blue: 0, 1, A, B
red: 2, C
#initial
++++++++++++++++++++++
+0 A               1 +
++B ++++++++ +++++++ +
++  +      + +     + +
++  +      + +     + +
++  +      + +     + +
++  +      + +     + +
++  +      + +     + +
++  ++++++++ +++++++ +
+   C             2  +
++++++++++++++++++++++
#goal
++++++++++++++++++++++
+0  A              1 +
++  ++++++++ +++++++ +
++B +      + +     + +
++  +      + +     + +
++  +      + +     + +
++  +      + +     + +
++  +      + +     + +
++  ++++++++ +++++++ +
+   C             2  +
++++++++++++++++++++++
#end