#domain
hospital
#levelname
MAAIFather
#colors
blue: 0, A
red: 1, C
green: 2, B
#initial
++++++++++++
+++++  C  A+
+++++ ++++++
++     1  0+
++++++++++++
+    B     +
+ B    2   +
+          +
++++++++++++
#goal
++++++++++++
+++++      +
+++++ ++++++
++CA       +
++++++++++++
+      B   +
+          +
+         B+
++++++++++++
#end
