#domain
hospital
#levelname
MAExample
#colors
red: 0, A
#initial
+++++++++++++++++++
+0               A+
+              ++++
+                 +
+              ++ +
+A              + +
+++++++++++++++++++
#goal
+++++++++++++++++++
+0                +
+              ++++
+                 +
+              ++A+
+               +A+
+++++++++++++++++++
#end
