#domain
hospital
#levelname
MAExample
#colors
red: 0, A, B, C
#initial
++++++++++++++++++++++
+0 A                 +
++B ++++++++ +++++++ +
++  +      + +     + +
++  +      + +     + +
++  +      + +     + +
++  +      + +     + +
++  +      + +     + +
++  ++++++++ +++++++ +
+                    +
++++++++++++++++++++++
#goal
++++++++++++++++++++++
+0  A                +
++  ++++++++ +++++++ +
++B +      + +     + +
++  +      + +     + +
++  +      + +     + +
++  +      + +     + +
++  +      + +     + +
++  ++++++++ +++++++ +
+                    +
++++++++++++++++++++++
#end
