#domain
hospital
#levelname
MAExample
#colors
red: 0, A
blue: B
#initial
++++++++++++++++++++++
+0  A       B        +
+   ++++++++A+++++++ +
++  +      + +     + +
++  +      + +     + +
++  +      + +     + +
++  +      + +     + +
++  +      + +     + +
++  ++++++++ +++++++ +
+                    +
++++++++++++++++++++++
#goal
++++++++++++++++++++++
+0           A       +
+   ++++++++ +++++++ +
++  +      + +     + +
++  +      + +     + +
++  +      + +     + +
++  +      + +     + +
++  +      + +     + +
++  ++++++++ +++++++ +
+              A     +
++++++++++++++++++++++
#end
