#domain
hospital
#levelname
MAExample
#colors
red: 0, B, A
#initial
++++++++
+  0+B +
+   +  +
+   +  +
+ ++++ +
+   ++ +
+      +
++++++++
#goal
++++++++
+   +  +
+   +  +
+   +  +
+ ++++ +
+   ++ +
+   B  +
++++++++
#end
