#domain
hospital
#levelname
MAExample
#colors
red: 0, B, A
#initial
++++++++
+     A+
+ ++++++
+   0+B+
+ ++++ +
+      +
++++++++
#goal
++++++++
+    A +
+ ++++++
+    + +
+ ++++ +
+    B +
++++++++
#end
