#domain
hospital
#levelname
MAExample
#colors
blue: 0, A, B, C, D
#initial
++++++++
+0+    +
+ A+   +
+ +B+  +
+   C+ +
+ ++++ +
+      +
++++++++
#goal
++++++++
+ + ABC+
+  +   +
+ + +  +
+    + +
+ ++++ +
+      +
++++++++
#end