#domain
hospital
#levelname
SAKaren
#colors
red: 0, B, A, C, D
cyan: X
green: Y
blue: Z
#initial
++++++++++++++++++++++++++++++++++++++++++++++++++
+                              0ZB               +
+ +                   +++++++++ Z+++++++++++++++ +
+ +                   +         Z                +
+ +                   +        AZ ++++++++++++++++
+ +                   ++++++++++Z                +
+  +++++++++++++++++++          +                +
+                               +                +
+ +++++++++++++++++++++++++++++ +                +
+                   +           +                +
+                   +           +                +
+                  D+           +                +
+ ++++++++++++++++++++++++++++++++               +
+                               ++               +
+                                                +
++++++++++++++++++++++++++++++++++++++++++++++++++
#goal
++++++++++++++++++++++++++++++++++++++++++++++++++
+                               Z                +
+ +                   +++++++++ Z+++++++++++++++ +
+ +                   +B        Z                +
+ +                   +         Z ++++++++++++++++
+ +                   ++++++++++Z              A +
+  +++++++++++++++++++          +                +
+                               +                +
+ +++++++++++++++++++++++++++++ +                +
+                   +           +                +
+                   +           +                +
+                   +D          +                +
+ ++++++++++++++++++++++++++++++++               +
+                               ++               +
+                                                +
++++++++++++++++++++++++++++++++++++++++++++++++++
#end
