#domain
hospital
#levelname
SAExample
#colors
red: 0, B, A, C
cyan: X
green: Y
blue: Z
#initial
++++++++++++++++++++++++++++++++++++++++++++++++++
+                        C     0ZB               +
+                     +++++++++ Z+++++++++++++++ +
+                     +         Z                +
+                     +        AZ ++++++++++++++++
+                     ++++++++++Z                +
+++++++++++++++++++++           +                +
+                               +                +
+ +++++++++++++++++++           +                +
+                   +           +                +
+                   +           +                +
+                   +           +                +
+ ++++++++++++++++++++++++++++++++               +
+                               ++               +
+                                                +
++++++++++++++++++++++++++++++++++++++++++++++++++
#goal
++++++++++++++++++++++++++++++++++++++++++++++++++
+                               Z                +
+                     +++++++++ Z+++++++++++++++ +
+                     +B      A Z                +
+                     +   C     Z ++++++++++++++++
+                     ++++++++++Z                +
+++++++++++++++++++++           +                +
+                               +                +
+ +++++++++++++++++++           +                +
+                   +           +                +
+                   +           +                +
+                   +           +                +
+ ++++++++++++++++++++++++++++++++               +
+                               ++               +
+                                                +
++++++++++++++++++++++++++++++++++++++++++++++++++
#end
