#domain
hospital
#levelname
SAExample
#colors
red: 0, B, A
cyan: X
green: Y
blue: Z
#initial
++++++++++++++++++++++++++++++++++++++++++++++++++
+                              0ZB               +
+                               Z+               +
+                               +                +
+                              A+                +
+                               +                +
+                               +                +
+                               +                +
+                               Z                +
+                               +                +
+ ++++++++++++++++++++++++++++++++               +
+                               ++               +
+                                                +
++++++++++++++++++++++++++++++++++++++++++++++++++
#goal
++++++++++++++++++++++++++++++++++++++++++++++++++
+                               Z                +
+                           B   Z+               +
+                             A +                +
+                               +                +
+                               +                +
+                               +                +
+                               +                +
+                               Z                +
+                               +                +
+ ++++++++++++++++++++++++++++++++               +
+                               ++               +
+                                                +
++++++++++++++++++++++++++++++++++++++++++++++++++
#end