#domain
hospital
#levelname
SAExample
#colors
red: 0, B, A, C
cyan: X
green: Y
blue: Z
#initial
++++++++++++++++++++++++++++++++++++++++++++++++++
+                              0+B               +
+                               ++++++++++++++++ +
+                               +                +
+                              A+ ++++++++++++++++
+                               +               C+
+                               +                +
+                               +                +
+                               +                +
+                               +                +
+ ++++++++++++++++++++++++++++++++               +
+                               ++               +
+                                                +
++++++++++++++++++++++++++++++++++++++++++++++++++
#goal
++++++++++++++++++++++++++++++++++++++++++++++++++
+                               +                +
+                           B   ++++++++++++++++ +
+                             A +                +
+                               + ++++++++++++++++
+                               +              C +
+                               +                +
+                               +                +
+                               +                +
+                               +                +
+ ++++++++++++++++++++++++++++++++               +
+                               ++               +
+                                                +
++++++++++++++++++++++++++++++++++++++++++++++++++
#end