#domain
hospital
#levelname
SAExample
#colors
red: 0, B, A, C
cyan: X
green: Y
blue: Z
#initial
++++++++++++++++++++++++++++++++++++++++++++++++++
+                              0+B               +
+                               ++++++++++++++++ +
+                               Z                +
+                              AZ ++++++++++++++++
+                               Z               C+
+                               Z                +
+                               +                +
+                               +                +
+                               +                +
+ ++++++++++++++++++++++++++++++++               +
+                               ++               +
+                                                +
++++++++++++++++++++++++++++++++++++++++++++++++++
#goal
++++++++++++++++++++++++++++++++++++++++++++++++++
+                               +                +
+                           B   ++++++++++++++++ +
+                             A Z                +
+                               Z ++++++++++++++++
+                               Z              C +
+                               Z                +
+                               +                +
+                               +                +
+                               +                +
+ ++++++++++++++++++++++++++++++++               +
+                               ++               +
+                                                +
++++++++++++++++++++++++++++++++++++++++++++++++++
#end
