#domain
hospital
#levelname
SAExample
#colors
red: 0, B, A, C
cyan: X
green: Y
blue: Z
#initial
++++++++++++++++++++++++++++++++++++++++++++++++++
+                     C        0+B               +
+                               ++++++++++++++++ +
+                               +                +
+                              A+ ++++++++++++++++
+                     +++++++++++                +
+++++++++++++++++++++           +                +
+                               +                +
+ +++++++++++++++++++           +                +
+                   +           +                +
+                   +           +                +
+                   +           +                +
+ ++++++++++++++++++++++++++++++++               +
+                               ++               +
+                                                +
++++++++++++++++++++++++++++++++++++++++++++++++++
#goal
++++++++++++++++++++++++++++++++++++++++++++++++++
+                               +                +
+                           B   ++++++++++++++++ +
+                             A +                +
+                         C     + ++++++++++++++++
+                     +++++++++++                +
+++++++++++++++++++++           +                +
+                               +                +
+ +++++++++++++++++++           +                +
+                   +           +                +
+                   +           +                +
+                   +           +                +
+ ++++++++++++++++++++++++++++++++               +
+                               ++               +
+                                                +
++++++++++++++++++++++++++++++++++++++++++++++++++
#end